A: . 3
B: x a
C: x 4
a: 2
b: a
map:
 ##############
 #.........#..#
 #.@.......#..#
 #...###......#
 #ABC# #......#
 #abc# #...####
 #...# #......#
 ##### ########

$
