A: . 3
B: x a
C: x 4
a: 2
b: a
x: 5 6 -1 
map:
 ###########
 #.........#
 #.@.......####
 #...###......#
 #ABC# #.....x#
 #abc###...####
 #.........#
 ###########

$";
